##########
#        #
#  ####  #
#  #S    #
#  #  #  #
#     #  #
##########